TTTTTTTTTTTTT
TD@@@@D@DDDDT
TD@XD@DDD@DDT
TD@P@D@DD@DDT
TDWMWWWWWWWWT
TPPPPPPPPPPPT
TPD@PPPPPPPPT
TPPD@PPPPPPPT
TPPPD@PPPPPPT
TPPPPDPPPPPPT
TPPPPPPPPPPPT
TPPPPPPPPPPPT
TTTTTTTTTTTTT
