TTTTTTTTTTTTTTT
TP@D@DDDDDDWPPT
TMDXDWDD*DDWPDT
TPDDMWDD@DDDDDT
TPDDPWDDDDDWDDT
TWWWWWWMWWWWDDT
TDDDDDDPDDDDDDT
TDBPPPPPPPDDDDT
TDPWWWWWWWWWMWT
TDPDDDDDDDDDPDT
TDDDDDDDDDDDPDT
TWWWWWWWWWWWBDT
TDDD@DDD@DDDDDT
TE@DDD@DDDDDDDT
TTTTTTTTTTTTTTT
