TTTTTTTTTTTTT
TD@D@DD@DDDDT
TD@XD@DDD@DDT
TD@D@D@DD@DDT
TWWMWWWWWWWWT
TPPPPPPPPPPPT
TPPPPPPPPPPPT
TPPPPPPPPPPPT
TPPPPPPPPPPPT
TPPPPPPPPPPPT
TPPPPPPPPPPPT
TPPPPPPPPPPPT
TTTTTTTTTTTTT
