TTTTTTTTTTTTTTTTTTTTTTTTTTTTTTTTTTTTTTTT
TDDDDDDPDD*D@PDDDDD@D@DDDDDDDPDDDD@DDDDT
TD@X*DDDDDDPDDDDDDDDD@*DD@DDDDPDDDDDPDDT
TDDDDDDDDDDPDDPDDDDD@D@DD@DDDDDDDD@DDDDT
T@DPPDDDDDDDDD@DDDDDD@DD@DDDD@DDD@DDDDDT
T@D@@DDDDDDDDD@@DD@DDDDDDDD@DDDDDD@D@PDT
TDDD@DD@DDDDDDDD@DDDDD@DP@DDDDDDDD@D@@DT
TWWWWMWWWWWWWPWWWWWWWWWWWWWWWWWDDD@DD@DT
TDPDDP@DD*DPDD@D@DDDDDDDDDD*D@PDDDDDD@DT
TDD*DPDDD@DDDDDPDDDDDDDD@PP@DD*DDDD@DDDT
TDDD@PD@D@DDDDDDDDDDDDDD@@D@DD@DDDDDDDDT
TDPDDPPP@DDDDDDDD@@PDDDDDDD@DD@D*DDDDPDT
TD@DDPPP@DPPDDDDD@D@*DD*DDDD@DDD@DD*D@DT
TD*@DPPPDDDDDDDDDD@@@DD@DDDDDDDD*DDDDD@T
TDDDDDDDDWWWWWWWWWWWWWWWWWWWWWWWWWWWWWWT
TPPDDDDDDDDDPDDD*DDDD@DDDDD@DDD@DDDDDDDT
T@PDDDDDDDDD@@DD@DDDDDDDD@DDDDDD@D@PDDET
TD@DD@DDDDDDDD@DDDDD@DPPDDDD*DDD@D@@DDDT
TDDDD@*DDPDDDDDDDD@DDDDDD@D@*DDDDDD@DDDT
TDDDPDDPD@DD@D@@DDDDDDDDD@D@*DDDDDD@DD@T
TD*DDDD@DDDDDPDDDDDDDDDPD@DD@DDDD@DDD@DT
TTTTTTTTTTTTTTTTTTTTTTTTTTTTTTTTTTTTTTTT
