TTTTTTTTTTTTTTT
T@DD@DDDDDDWPPT
TDXDDWDD*DDWPDT
TMDDMWDD@DDDDDT
TDDDPWDDDDDWDDT
TWWWWWWMWWWWDDT
TDDDDDDPDDDDDDT
TDBPPPPPPPDDDDT
TDPWWWWWWWWWMWT
TDPDDDDDDDDDPDT
TDDDDDDDDDDDPDT
TWWWWWWWWWWWBDT
TDDD@DDD@DDDDDT
TE@DDD@DDDDDDDT
TTTTTTTTTTTTTTT
