TTTTTTTTTTTTTTT
TPPPPPPPPPPPPPT
TPPXPPWWPPPPPPT
TPPPPPWFPPPPPPT
TPPPPPPPPPPPPPT
TPPPPPPPPPPPPPT
TPPPPPPPPPPPPPT
TPPPPPPPPPPPPPT
TPPPPPPPPPPPPPT
TPPPPPPPPPPPPPT
TPPPPPPPPPPPPPT
TPPPPPPPPPPPPPT
TPPPPPPPPPPPPPT
TPPPPPPPPPPPPPT
TTTTTTTTTTTTTTT
