TTTTTTTTTTTTT
TD@DDDD@DDDDT
TD@XDDDDD@DDT
TD@D@D@DD@DDT
TWWMWWWWWWWDT
TPPPPPP*****T
TPPPPPP*****T
TPPPPPP*****T
TPPPPPPPPPPPT
TPPPPPPPPPPPT
TPPPPPPPPPPPT
TPPPPPPPPPPPT
TTTTTTTTTTTTT
