TTTTTTTTTTTTT
TD@DDDD@DDDDT
TD@XDDDDD@DDT
TD@D@D@DD@DDT
TWWMWWWWWWWWT
TPPPPPPPPPPPT
TPPPPPPPPPPPT
TPPPPPPPPPPPT
TPPPPPPPPPPPT
TPPPPPPPPPPPT
TPPPPPPPPPPPT
TPPPPPPPPPPPT
TTTTTTTTTTTTT
