TTTTTTTTTTTTTTTTTTTTTTTTTTTTTTTTTTTTTTTT
TDDDDDDPDD*D@PDDDDD@D@DDDDDDDPDDDD@DDDDT
TD@X@DDDDDDPDDDDDDDDD@*DD@DDDDPDDDDDPDDT
TDDDDDDDDDDPDDPDDDDD@D@DD@DDDDDDDD@DDDDT
T@DPPDDDDDDDDD@DDDDDD@DD@DDDD@DDD@DDDDDT
T@@D@DDDDDDDDD@@DD@DDDDDDDD@DDDDDD@D@PDT
TDDD@DD@DDDDDDDD@DDDDD@DP@DDDDDDDD@D@@DT
TWWWWWWWWWWWWWWWWWWWWWWWWWWWWWWDDD@DD@DT
TDPDDD@DD*DPDD@D@DDDDDDDDDD*D@PDDDDDD@DT
TDD*DDDDD@DDDDDPDDDDDDDD@PP@DD*DDDD@DDDT
TDDD@DD@D@DDDDDDDDDDDDDD@@D@DD@DDDDDDDDT
TDPDDDDD@DDDDDDDD@@PDDDDDDD@DD@D*DDDDPDT
TD@DDPDD@DPPDDDDD@D@*DD*DDDD@DDD@DD*D@DT
TD*@DDDDDDDDDDDDDD@@@DD@DDDDDDDD*DDDDD@T
TDDDDDDDDWWWWWWWWWWWWWWWWWWWWWWWWWWWWWWT
TPPDDDDDDDDDPDDD*DDDD@DDDDD@DDD@DDDDDDDT
T@PDDDDDDDDD@@DD@DDDDDDDD@DDDDDD@D@PDDET
TD@DD@DDDDDDDD@DDDDD@DPPDDDD*DDD@D@@DDDT
TDDDD@*DDPDDDDDDDD@DDDDDD@D@*DDDDDD@DDDT
TDDDPDDPD@DD@D@@DDDDDDDDD@D@*DDDDDD@DD@T
TD*DDDD@DDDDDPDDDDDDDDDPD@DD@DDDD@DDD@DT
TTTTTTTTTTTTTTTTTTTTTTTTTTTTTTTTTTTTTTTT
